Date,Description,Debit,Credit,Balance
2024-01-15,DEPOSIT - DAILY SALES,,"2,345.67","15,234.56"
2024-01-15,ABC COFFEE SUPPLIES,425.00,,"14,809.56"
2024-01-16,PAYROLL - WEEKLY,"3,200.00",,"11,609.56"
2024-01-16,DEPOSIT - DAILY SALES,,"1,987.43","13,596.99"
2024-01-17,UTILITY BILL - ELECTRIC,234.56,,"13,362.43"
2024-01-17,DEPOSIT - DAILY SALES,,"2,100.00","15,462.43"
2024-01-18,FOOD DISTRIBUTOR INC,"1,234.78",,"14,227.65"
2024-01-18,DEPOSIT - DAILY SALES,,"1,876.54","16,104.19"
